a	ki	
ai	ge	
an	hi	
ang	re	
ao	be	
ba	ak	
bai	ag	
ban	ah	
bang	ar	
bao	ab	
bei	aw	
ben	an	
beng	at	
bi	af	
bian	aj	
biao	am	
bie	ai	
bin	ad	
bing	as	
bo	a	Y
bu	av	
ca	pk	
cai	pg	
can	ph	
cang	pr	
cao	pb	
ce	pa	
cen	pn	
ceng	pt	
cha	bk	
chai	bg	
chan	bh	
chang	br	
chao	bb	
che	ba	
chen	bn	
cheng	bt	
chi	b	Y
chong	bu	
chou	by	
chu	bv	
chua	bf	
chuai	bs	
chuan	bo	
chuang	bj	
chui	bd	
chun	bl	
chuo	bx	
ci	p	Y
cong	pu	
cou	py	
cu	pv	
cuan	po	
cui	pd	
cun	pl	
cuo	px	
da	jk	
dai	jg	
dan	jh	
dang	jr	
dao	jb	
de	j	Y
dei	jw	
den	jn	
deng	jt	
di	jf	
dia	jc	
dian	jj	
diao	jm	
die	ji	
ding	js	
diu	ja	
dong	ju	
dou	jy	
du	jv	
duan	jo	
dui	jd	
dun	jl	
duo	jx	
e	ae	
ei	w	
en	ni	
eng	t	
er	z	Y
fa	ok	
fan	oh	
fang	or	
fei	ow	
fen	on	
feng	ot	
fiao	om	
fo	ox	
fou	oy	
fu	ov	
ga	hk	
gai	hg	
gan	hh	
gang	hr	
gao	hb	
ge	h	Y
gei	hw	
gen	hn	
geng	ht	
gong	hu	
gou	hy	
gu	hv	
gua	hf	
guai	hs	
guan	ho	
guang	hj	
gui	hd	
gun	hl	
guo	hx	
ha	gk	
hai	gg	
han	gh	
hang	gr	
hao	gb	
he	g	Y
hei	gw	
hen	gn	
heng	gt	
hong	gu	
hou	gy	
hu	gv	
hua	gf	
huai	gs	
huan	go	
huang	gj	
hui	gd	
hun	gl	
huo	gx	
ji	d	Y
jia	dc	
jian	dj	
jiang	de	
jiao	dm	
jie	di	
jin	dd	
jing	ds	
jiong	dv	
jiu	da	
ju	dn	
juan	df	
jue	dl	
jun	dk	
ka	ek	
kai	eg	
kan	eh	
kang	er	
kao	eb	
ke	e	Y
kei	ew	
ken	en	
keng	et	
kong	eu	
kou	ey	
ku	ev	
kua	ef	
kuai	es	
kuan	eo	
kuang	ej	
kui	ed	
kun	el	
kuo	ex	
la	sk	
lai	sg	
lan	sh	
lang	sr	
lao	sb	
le	s	Y
lei	sw	
leng	st	
li	sf	
lia	sc	
lian	sj	
liang	se	
liao	sm	
lie	si	
lin	sd	
ling	ss	
liu	sa	
lo	sx	
long	su	
lou	sy	
lu	sv	
luan	so	
lue	sl	
lun	sl	
luo	sx	
lv	sn	
ma	rk	
mai	rg	
man	rh	
mang	rr	
mao	rb	
me	r	Y
mei	rw	
men	rn	
meng	rt	
mi	rf	
mian	rj	
miao	rm	
mie	ri	
min	rd	
ming	rs	
miu	ra	
mo	r	Y
mou	ry	
mu	rv	
na	ik	
nai	ig	
nan	ih	
nang	ir	
nao	ib	
ne	i	Y
nei	iw	
nen	in	
neng	it	
ni	if	
nian	ij	
niang	ir	
niao	im	
nie	ii	
nin	id	
ning	is	
niu	ia	
nong	iu	
nou	iy	
nu	iv	
nun	il	
nuan	io	
nue	il	
nuo	ix	
nv	in	
o	x	Y
ou	yi	
pa	qk	
pai	qg	
pan	qh	
pang	qr	
pao	qb	
pei	qw	
pen	qn	
peng	qt	
pi	qf	
pian	qj	
piao	qm	
pie	qi	
pin	qd	
ping	qs	
po	q	Y
pou	qy	
pu	qv	
qi	m	Y
qia	mc	
qian	mj	
qiang	me	
qiao	mm	
qie	mi	
qin	md	
qing	ms	
qiong	mv	
qiu	ma	
qu	mn	
quan	mf	
que	ml	
qun	mk	
ran	ch	
rang	cr	
rao	cb	
re	ca	
ren	cn	
reng	ct	
ri	c	Y
rong	cu	
rou	cy	
ru	cv	
rua	cf	
ruan	co	
rui	cd	
run	cl	
ruo	cx	
sa	wk	
sai	wg	
san	wh	
sang	wr	
sao	wb	
se	wa	
sen	wn	
seng	wt	
sha	kk	
shai	kg	
shan	kh	
shang	kr	
shao	kb	
she	ka	
shei	kw	
shen	kn	
sheng	kt	
shi	k	Y
shou	ky	
shu	kv	
shua	kf	
shuai	ks	
shuan	ko	
shuang	kj	
shui	kd	
shun	kl	
shuo	kx	
si	w	Y
song	wu	
sou	wy	
su	wv	
suan	wo	
sui	wd	
sun	wl	
suo	wx	
ta	tk	
tai	tg	
tan	th	
tang	tr	
tao	tb	
te	t	Y
tei	tw	
teng	tt	
ti	tf	
tian	tj	
tiao	tm	
tie	ti	
ting	ts	
tong	tu	
tou	ty	
tu	tv	
tuan	to	
tui	td	
tun	tl	
tuo	tx	
wa	vk	
wai	vg	
wan	vh	
wang	vr	
wei	vw	
wen	vn	
weng	vt	
wo	x	Y
wu	v	Y
xi	u	Y
xia	uc	
xian	uj	
xiang	ue	
xiao	um	
xie	ui	
xin	ud	
xing	us	
xiong	uv	
xiu	ua	
xu	un	
xuan	uf	
xue	ul	
xun	uk	
ya	fk	
yan	fh	
yang	fr	
yao	fb	
ye	fa	
yi	f	Y
yin	fn	
ying	ft	
yo	fx	
yong	fu	
you	fy	
yu	n	Y
yuan	nh	
yue	na	
yun	nn	
za	yk	
zai	yg	
zan	yh	
zang	yr	
zao	yb	
ze	ya	
zei	yw	
zen	yn	
zeng	yt	
zha	lk	
zhai	lg	
zhan	lh	
zhang	lr	
zhao	lb	
zhe	la	
zhei	lw	
zhen	ln	
zheng	lt	
zhi	l	Y
zhong	lu	
zhou	ly	
zhu	lv	
zhua	lf	
zhuai	ls	
zhuan	lo	
zhuang	lj	
zhui	ld	
zhun	ll	
zhuo	lx	
zi	y	Y
zong	yu	
zou	yy	
zu	yv	
zuan	yo	
zui	yd	
zun	yl	
zuo	yx	